30;;;;;;;;;;;;;;;;;;;;;;;;;;;;;
30;;;;;;;;;;;;;;;;;;;;;;;;;;;;;
21;29;29;29;29;29;29;29;29;29;29;29;29;29;29;29;29;29;29;29;29;29;29;29;29;29;29;29;29;21
22;8;8;8;8;8;8;8;8;8;8;8;8;8;8;8;8;8;8;8;8;8;8;8;8;8;8;8;8;20
22;1;2;2;2;2;3;8;8;8;8;8;8;8;8;8;8;8;8;8;8;8;8;8;8;8;8;8;8;20
22;9;10;10;10;10;11;8;8;8;8;8;8;8;8;8;8;8;8;8;8;8;8;8;8;8;8;8;8;20
22;9;10;10;10;10;11;8;8;8;8;8;8;8;8;8;8;8;8;8;8;8;8;8;8;8;8;8;8;20
22;9;10;10;10;10;11;8;8;8;8;8;8;8;8;8;8;8;8;8;8;8;8;8;8;8;8;8;8;20
22;9;10;10;10;10;11;8;8;8;8;8;8;8;8;8;8;8;8;8;8;8;8;8;8;8;8;8;8;20
22;8;8;8;25;25;8;8;8;8;8;8;8;8;8;8;8;8;8;8;8;8;8;8;8;8;8;8;8;20
22;8;8;8;33;33;34;35;35;36;35;8;8;8;8;8;8;8;8;8;8;8;8;8;8;8;8;8;8;20
22;8;8;33;33;33;34;35;35;35;36;8;8;8;8;8;8;8;8;8;8;8;8;8;8;8;8;8;8;20
22;8;8;33;33;33;8;8;8;8;36;8;8;8;8;8;8;8;8;8;8;8;8;8;8;8;8;8;8;20
22;8;8;33;33;33;8;8;8;8;36;8;8;8;8;8;8;8;8;8;8;8;8;8;8;8;8;8;8;20
22;8;8;33;33;33;8;8;8;8;36;8;8;8;8;8;8;8;8;8;8;8;8;8;8;8;8;8;8;20
22;8;8;8;8;8;8;8;8;8;36;36;8;8;8;8;8;8;8;8;8;8;8;8;8;8;8;8;8;20
22;8;8;8;8;8;8;8;8;8;8;36;8;8;8;8;8;8;8;8;8;8;8;8;8;8;8;8;8;20
22;8;8;8;8;8;8;8;8;8;8;36;36;8;8;8;8;8;8;8;8;8;8;8;8;8;8;8;8;20
22;8;8;8;8;8;8;8;8;8;8;8;36;8;8;8;8;8;8;8;8;8;8;8;8;8;8;8;8;20
22;8;8;8;8;8;8;8;8;8;8;8;36;36;36;36;8;8;8;8;8;8;8;8;8;8;8;8;8;20
22;8;8;8;8;8;8;8;8;8;8;8;8;8;8;36;36;36;36;36;8;8;8;8;8;8;8;8;8;20
22;8;8;8;8;8;8;8;8;8;8;8;8;8;8;8;8;8;8;36;36;36;36;36;36;36;36;36;36;36
22;8;8;8;8;8;8;8;8;8;8;8;8;8;8;8;8;8;8;8;8;8;8;8;8;8;8;8;8;20
22;8;8;8;8;8;8;8;8;8;8;8;8;8;8;8;8;8;8;8;8;8;8;8;8;8;8;8;8;20
22;8;8;8;8;8;8;8;8;8;8;8;8;8;8;8;8;8;8;8;8;8;8;8;8;8;8;8;8;20
22;8;8;8;8;8;8;8;8;8;8;8;8;8;8;8;8;8;8;8;8;8;8;8;8;8;8;8;8;20
22;8;8;8;8;8;8;8;8;8;8;8;8;8;8;8;8;8;8;8;8;8;8;8;8;8;8;8;8;20
22;8;8;8;8;8;8;8;8;8;8;8;8;8;8;8;8;8;8;8;8;8;8;8;8;8;8;8;8;20
22;8;8;8;8;8;8;8;8;8;8;8;8;8;8;8;8;8;8;8;8;8;8;8;8;8;8;8;8;20
22;8;8;8;8;8;8;8;8;8;8;8;8;8;8;8;8;8;8;8;8;8;8;8;8;8;8;8;8;20
22;8;8;8;8;8;8;8;8;8;8;8;8;8;8;8;8;8;8;8;8;8;8;8;8;8;8;8;8;20
21;13;13;13;13;13;13;13;13;13;13;13;13;13;13;13;13;13;13;13;13;13;13;13;13;13;13;13;13;21
